##########################################
#E  ######################################
#         #  #     #           #     #  ##
##  #######  #  #  #  ##########  ####  ##
##        #  #  #                       ##
#####  ####  ####  #######  #######  #  ##
##  #              #  #     #     #  #  ##
##  #  ####  #  #  #  #######  #######  ##
##  #     #  #  #  #   C #  #  #     #  ##
##  #  #######  #######  #  #  #  ####  ##
##     #  #     U           #        #  ##
########  #  ##########  #  #######  #  ##
##        #     #        #  #           ##
##  ####  ####  ##########  ####  ########
##     #  #        #           #  #     ##
##  #  #  ####  #######  #  #  #  #  #####
##  #  #     #     #  #  #  #  #     #  ##
##  #############  #  #  #######  ####  ##
##     #           #           #        ##
#####  ####  #  #  ####  #  #  #  #  #####
##  #        #  #    F#  #  #  #  #     ##
##  #  ####  ####  ####  #############  ##
##        #     #  #     #     #        ##
##  #######  ####  #  ####  #######  #####
##  #        #  #  #        #     #     ##
#####  ####  #  ##########  #  #  ####  ##
##        #     #              #     #   #
######################################   #
##########################################