##########################################
# E ######################################
#               #     #        #        ##
##  #######  #  #  ####  ####  #  #  #####
##  #        #  #     #     #     #     ##
##  ####  #  #######  #  #  ##############
##     #  #              #  #     #     ##
##  ################  #######  #  #  #  ##
##     #                 #     #  #  #  ##
##  #  #######  ####  #  #### U####  #  ##
##  #        #     #  #  #  #        #  ##
##  #############  ####  #  #  ####  #####
##  #  #              #    C#  #        ##
##  #  #  ####  #  #  #  ####  ####  #####
##     #  #  #  #  #  #           #  #  ##
##  #######  ##########  ####  #######  ##
##     #           #     #  #     #     ##
##  ##########  ##########  #  ####  #  ##
##  #  #          F#                 #  ##
##  #  ####  #  #######  ####  ####  #####
##        #  #           #  #     #  #  ##
#####  #######  ####  ####  #  ####  #  ##
##     #  #  #  #  #        #     #  #  ##
##  #  #  #  ####  ##########  #######  ##
##  #  #        #           #  #     #  ##
##  ##########  ####  #  ####  ####  #  ##
##  #                 #                  #
#####################################   ##
##########################################