######################
#E       #############
#######    ####      #
########C        ###F#
############ U########
######################